#######################
#.....................#
#####################.#
#........==.=.........#
#.###################.#
#%....................#
#.#####################
#...........=.........#
#####################.#
#.....................#
#.#####################
#...........\.........#
#####################.#
#.....................#
#.#####################
#...........=.........#
#######################



#######################
#..........\..........#
#.#.#.#.#.#.#.#.#.#.#.#
#.....................#
#.#.#.#.#.#.#.#.#.#.#.#
#.....................#
#.#.#.#.#=#.#.#=#.#.#.#
#.....................#
#.#.#.#.#.#.#.#.#.#.#.#
#.....................#
#.#.#.#.#.#.#.#.#.#.#.#
#.....................#
#.#.#.#.#=#.#.#=#.#.#.#
#.....................#
#.#.#.#.#.#.#.#.#.#.#.#
#.....................#
#.#.#.#.#.#.#.#.#.#.#.#
#.....................#
#.#.#.#.#.#.#.#.#.#.#.#
#..........%..........#
#######################




#######################
#..........=..........#
#.#########.#########.#
#.#........=........#.#
#.#.###############.#.#
#.#.#......=......#.#.#
#.#.#.#####.#####.#.#.#
#.#.#.#....=....#.#.#.#
#.#.#.#.#######.#.#.#.#
#.#.#.#.#..=..#.#.#.#.#
#.#.#.#.#.###.#.#.#.#.#
#.#.#.#.#.#%#.#.#.#.#.#
#.#.#.#.#.#.#.#.#.#.#.#
#.#.#.#.#.....#.#.#.#.#
#.#.#.#.###.###.#.#.#.#
#.#.#.#.........#.#.#.#
#.#.#.###########.#.#.#
#.#.#.............#.#.#
#.#.#######.#######.#.#
#.#.................#.#
#.#########.#########.#
#..........\..........#
#######################
